...###
...###
..##.#.####
.##..###..#
##........#
#...@..#..#
#.....#..#
#.....#..#
###..###..#
..#..#....#
